NO              ./textures/chair_shinji
SO ./textures/berserk


WE ./textures/sun
EA ./textures/rei


                 F 220,100,0

C 220,100,0



        1111111111111111111111110
        1000000000100000000000001
        1011000S00000000000000001
        1111111111111111111111111