NO              ./textures/chair_shinji
SO ./textures/berserk


WE ./textures/sun
EA ./textures/rei


                 F 220,100,0







        1111111111111111111111111
        1000000000110000000000001
        1011000S01110000000000001
        1111111111111111111111111


